▄     ▄    ▄    ▄▄▄▄▄▄ 
█▀▄ ▄▀█  ▄█▀█▄  █     █
█  ▀  █ ██▄▄▄██ █▀▀▀▀▀ 
█     █ █     █ █      
▀     ▀ ▀     ▀ ▀      